ABA	ABA.processed_GPS_events.txt
ABF1_ABA	ABF1_ABA.processed_GPS_events.txt
ABF1_EtOH	ABF1_EtOH.processed_GPS_events.txt
ABF3_ABA	ABF3_ABA.processed_GPS_events.txt
ABF3_EtOH	ABF3_EtOH.processed_GPS_events.txt
ABF4_ABA	ABF4_ABA.processed_GPS_events.txt
ABF4_EtOH	ABF4_EtOH.processed_GPS_events.txt
ANAC032_ABA	ANAC032_ABA.processed_GPS_events.txt
ANAC032_EtOH	ANAC032_EtOH.processed_GPS_events.txt
anac055_air	anac055_air.processed_GPS_events.txt
anac055_eth	anac055_eth.processed_GPS_events.txt
ANAC102_ABA	ANAC102_ABA.processed_GPS_events.txt
ANAC102_EtOH	ANAC102_EtOH.processed_GPS_events.txt
bes1_air	bes1_air.processed_GPS_events.txt
bes1_br	bes1_br.processed_GPS_events.txt
bes1_eth	bes1_eth.processed_GPS_events.txt
DREB2A_ABA	DREB2A_ABA.processed_GPS_events.txt
DREB2A_EtOH	DREB2A_EtOH.processed_GPS_events.txt
edf1_air	edf1_air.processed_GPS_events.txt
edf1_eth	edf1_eth.processed_GPS_events.txt
edf2_air	edf2_air.processed_GPS_events.txt
edf2_eth	edf2_eth.processed_GPS_events.txt
edf2_ja	edf2_ja.processed_GPS_events.txt
edf3_air	edf3_air.processed_GPS_events.txt
edf3_eth	edf3_eth.processed_GPS_events.txt
ein3_air	ein3_air.processed_GPS_events.txt
ein3_eth	ein3_eth.processed_GPS_events.txt
ein3_ja	ein3_ja.processed_GPS_events.txt
EtOH	EtOH.processed_GPS_events.txt
FBH3_ABA	FBH3_ABA.processed_GPS_events.txt
FBH3_EtOH	FBH3_EtOH.processed_GPS_events.txt
GBF2_ABA	GBF2_ABA.processed_GPS_events.txt
GBF2_EtOH	GBF2_EtOH.processed_GPS_events.txt
GBF3_ABA	GBF3_ABA.processed_GPS_events.txt
GBF3_EtOH	GBF3_EtOH.processed_GPS_events.txt
HAT22_ABA	HAT22_ABA.processed_GPS_events.txt
HAT22_EtOH	HAT22_EtOH.processed_GPS_events.txt
HB5_ABA	HB5_ABA.processed_GPS_events.txt
HB5_EtOH	HB5_EtOH.processed_GPS_events.txt
HB6_ABA	HB6_ABA.processed_GPS_events.txt
HB6_EtOH	HB6_EtOH.processed_GPS_events.txt
HB7_ABA	HB7_ABA.processed_GPS_events.txt
HB7_EtOH	HB7_EtOH.processed_GPS_events.txt
HSFA6A_ABA	HSFA6A_ABA.processed_GPS_events.txt
HSFA6A_EtOH	HSFA6A_EtOH.processed_GPS_events.txt
ja_anac055_air	ja_anac055_air.processed_GPS_events.txt
ja_anac055_ja	ja_anac055_ja.processed_GPS_events.txt
ja_erf1_ja	ja_erf1_ja.processed_GPS_events.txt
ja_myc2_air	ja_myc2_air.processed_GPS_events.txt
ja_myc2_ja	ja_myc2_ja.processed_GPS_events.txt
ja_myc3_air	ja_myc3_air.processed_GPS_events.txt
ja_myc3_ja	ja_myc3_ja.processed_GPS_events.txt
ja_obp2_air	ja_obp2_air.processed_GPS_events.txt
ja_obp2_ja	ja_obp2_ja.processed_GPS_events.txt
ja_rap2.6l_air	ja_rap2.6l_air.processed_GPS_events.txt
ja_rap2.6l_ja	ja_rap2.6l_ja.processed_GPS_events.txt
ja_stz_air	ja_stz_air.processed_GPS_events.txt
ja_stz_ja	ja_stz_ja.processed_GPS_events.txt
ja_tcp3_air	ja_tcp3_air.processed_GPS_events.txt
ja_tcp3_ja	ja_tcp3_ja.processed_GPS_events.txt
MYB3_ABA	MYB3_ABA.processed_GPS_events.txt
MYB3_EtOH	MYB3_EtOH.processed_GPS_events.txt
MYB44_ABA	MYB44_ABA.processed_GPS_events.txt
MYB44_EtOH	MYB44_EtOH.processed_GPS_events.txt
myc2_air	myc2_air.processed_GPS_events.txt
myc2_eth	myc2_eth.processed_GPS_events.txt
myc3_air	myc3_air.processed_GPS_events.txt
myc3_eth	myc3_eth.processed_GPS_events.txt
NFYB2_ABA	NFYB2_ABA.processed_GPS_events.txt
NFYB2_EtOH	NFYB2_EtOH.processed_GPS_events.txt
NFYC2_ABA	NFYC2_ABA.processed_GPS_events.txt
NFYC2_EtOH	NFYC2_EtOH.processed_GPS_events.txt
obp2_air	obp2_air.processed_GPS_events.txt
obp2_eth	obp2_eth.processed_GPS_events.txt
rap2.6l_air	rap2.6l_air.processed_GPS_events.txt
rap2.6l_eth	rap2.6l_eth.processed_GPS_events.txt
RD26_ABA	RD26_ABA.processed_GPS_events.txt
RD26_EtOH	RD26_EtOH.processed_GPS_events.txt
stz_eth	stz_eth.processed_GPS_events.txt
tcp3_air	tcp3_air.processed_GPS_events.txt
tcp3_br	tcp3_br.processed_GPS_events.txt
tcp3_eth	tcp3_eth.processed_GPS_events.txt
tga5_air	tga5_air.processed_GPS_events.txt
tga5_eth	tga5_eth.processed_GPS_events.txt
tga5_sa	tga5_sa.processed_GPS_events.txt
ZAT6_ABA	ZAT6_ABA.processed_GPS_events.txt
ZAT6_EtOH	ZAT6_EtOH.processed_GPS_events.txt
